1111111111111111111111111111111111111111111111
1000000000000000000000000000011100000000000001
100000000000000000000000000001C100000000000001
1000000000000000000000000000011100000000000001
1000000000000000000000000000000000000000000001
1000000000000000000000000000000000000000000001
100000000000000000000000000000000000C000000001
100000000C000000000000000000000000000000000001
1000000000000000000000000000000000000000000001
1000000000000000000000000000000000000000000001
10000000000000C0000000000000000000000000000001
1000P0000000000000000000000000000000E000000001
1000000000000000000000000000000000000000000001
1000000000000000000000000000000000000000000001
1111111111111111111111111111111111111111111111
