111111111
10100P1E1
10100C101
110100001
100000011
111111111
