111111111
1010EP111
1010C1101
11010001
100000011
111111111
