111111111
10100P1E1
101001101
11010001
100000011
111111111
